
WE  maps/texture/zelig4.png
NO  maps/texture/zelig6.png
SO  maps/texture/zelig7.png
EA  maps/texture/zelig5.png

F 150,100,50
C 50,200,255

111111111111111111111
1N0000000011111000001
111011111101000101111
100010000001011101001
101110111101010001111
100000100000010001001
111110101111110111101
100000101000000100001
101111101011111101111
100000001000001000001
101111111111101111101
100000000000001000001
101111111111101111101
100000100000001000001
111110101111101111101
100000101000001000001
101111101011111111111
100000001000000000001
111111111111111111101
100000000000000000001
111111111111111111111
