     WE                            textures/wolfenstein/grey_stone.xpm   
NO      textures/wolfenstein/purple_stone.xpm   





SO textures/wolfenstein/red_brick.xpm  
C 218,234,235       
 
F      17,38,64   

EA textures/wolfenstein/wood.xpm   




1111111111111111111111111        
1000110000100000000000001   
100011000000000111111001
1000110000000000110001001111111
100000000010000000W001001 
1111111111111111111111111   












