WE      maps/texture/zelig4.png
NO      maps/texture/zelig6.png
SO      maps/texture/zelig7.png
EA      maps/texture/zelig5.png


C	218,234,235
 
F      17,38,64   


      


1111111111111111111 1111111    111
      1000000000001 10000001
      101110101011111110001111
       1  100010000000000010001
 11111 1   111110101111101011101
1000001011111111001011  1 1   1
101111101 1000000111111
101000001110100000101
101011111010111110101
101010001010000010101
101110101010101010101
100000101010001010001
111111101011111011101
100000101000100000001
101110101110101110111
101000100000100010101
101011111111111010101
1N0010000000000000001
101010111011111111101
101000001000000000001
111111111111111111111 


