NO ./path_to_the_north_texture
SO ./path_to_the_south_texture
WE ./path_to_the_west_texture
EA ./path_to_the_east_texture

F 220,100,0
C 225,30,0

1111111111111111111111111
1000000000110000000000001111
1011000001110001000000001001
10010000000000001000000011011111
111111111011001001110000000000001
10000000001100010111011111111111
11110111111111N10000000010001
11110111111111011101010010001
11000000110101011100000010001
1000000000000000110000000001
10000000000000001101010010001
1100000111010101111101111000111
1111011111101011011110100011
111111111111111111111111111


