NO textures/wall_40_1.xpm     





            EA textures/wall_40_4.xpm                   
            C     34 , +0    , +3



WE textures/wall_40_3.xpm
SO textures/wall_40_2.xpm


            F    +3 , -0  ,  255






11111111111                                
10000E00011
10000000011
11111111111



