

WE      maps/texture/rome1.png
        NO      maps/texture/rome2.png








EA      maps/texture/rome3.png               



C	218,234,255
 
F      17,38,64         
 








SO      maps/texture/rome4.png

 
      111111111111111111111111111111
      11111111111E11111111111111      
      1000000000000000000000000011111111111111     1
 111110000000000000000000000000100000000000001111111
1000000000000000000000000010111111111111111111    11
1000000000000000000000000111
100000000000000000000000001
100000000000000000000000001
100000000000000000000000001
100000000000000000000000001
100000000000000000000000001
100000000000000000000000001
100000000000000000000000001
111111111111111111111111111

