
F    +3 , -0  ,  255

WE      maps/texture/zelig3.png
        NO      maps/texture/zelig.png








EA      maps/texture/pharoah.png                



C     34,0,3        
 








SO      maps/texture/zelig4.png

 

11111111111   
1001111000N1
1111  1111111   1
111111

