

WE      maps/texture/zelig3.png
        NO      maps/texture/zelig.png








EA      maps/texture/pharoah.png                



C	218,234,235
 
F      17,38,64         
 








SO      maps/texture/zelig4.png

 
111111111111111111111111111
100000000000000000000000001
100000000000000000000000001
100000000000000000000000001
100000000000000000000000001
100000000000000000000000001
100000000000000000000000001
100000000000000000000000001
100000000000000000000000001
10000000000N000000000000001
100000000000000000000000001
100000000000000000000000001
100000000000000000000000001
111111111111111111111111111

