EA      maps/texture/rome3.png               
F      255,255,255         
 


WE      maps/texture/rome1.png
        NO      maps/texture/rome2.png

SO maps/texture/rome4.png


     

SO maps/texture/rome4.png
C	0,0,255
 
SO maps/texture/rome4.png
SO maps/texture/rome4.png
SO maps/texture/rome4.png
SO maps/texture/rome4.png

 SO maps/texture/rome4.png
SO maps/texture/rome4.png
SO maps/texture/rome4.png
SO maps/texture/rome4.png
SO maps/texture/rome4.png
SO maps/texture/rome4.png
SO maps/texture/rome4.png
SO maps/texture/rome4.png
SO maps/texture/rome4.png
SO maps/texture/rome4.png
SO maps/texture/rome4.png
SO maps/texture/rome4.png
SO maps/texture/rome4.png
SO maps/texture/rome4.png
SO maps/texture/rome4.png
SO maps/texture/rome4.png
SO maps/texture/rome4.png
SO maps/texture/rome4.png
SO maps/texture/rome4.png
SO maps/texture/rome4.png
SO maps/texture/rome4.png
SO maps/texture/rome4.png
SO maps/texture/rome4.png
SO maps/texture/rome4.png
SO maps/texture/rome4.png
SO maps/texture/rome4.png
SO maps/texture/rome4.png
SO maps/texture/rome4.png
SO maps/texture/rome4.png
SO maps/texture/rome4.png
SO maps/texture/rome4.png
SO maps/texture/rome4.png
SO maps/texture/rome4.png
SO maps/texture/rome4.png
SO maps/texture/rome4.png
SO maps/texture/rome4.png
SO maps/texture/rome4.png
SO maps/texture/rome4.png
SO maps/texture/rome4.png
SO maps/texture/rome4.png
SO maps/texture/rome4.png
SO maps/texture/rome4.png
SO maps/texture/rome4.png
SO maps/texture/rome4.png

111111111111111111111111111111111111111111111111111111111111111111111111111111111111111111111111111111111111111111111111111111111111111111111111111111111111111111111111111111111111111111111111111111111111111111111111111111111111
100000000000000000000000000000000000000000000000000000000000000000000000000000000000000000000000000000000000000000000000000000000000000000000000000000000000000000000000000000000000000000000000000000000000000000000000000000000001
1N0111111111111111111111111111111111111111111111111111111111111111111111111111111111111111111111111111111111111111111111111111111111111111111111111111111111111111111111111111111111111111111111111111111111111111111111111111111111
100000000000000000000000111
100000000000000000000000001
100000000000000000000000001
100000000000000000000000001
1000000000000000000000000001
1000000000000000010000000001
10000000000000001 10000000001
100000000000000001 1000000001
11111111111111111111111111111