NO textures/wall_40_1.xpm     





            EA textures/wall_40_4.xpm                   
            C     34 , +0    , +3



WE textures/wall_40_3.xpm
SO textures/wall_40_2.xpm


            F    +3 , -0  ,  255






111111111111111111111111                                
10000000001100000000000011111       
1011000001110000000000001001   
10010000000011111110000011011111111     
1111111110001   1  1111000000000000111    
10000000001111111111110111111111111
11110111111111011100000010001
11110111111111011101010010001
11000000110101011100000010001
1000000000000000110000001001
10000000000000001101010010001
1100000111010101111101111N00111
1111011111101011011110100011
111111111111111111111111111




