
F    +3 , -0  ,  255

WE      maps/texture/zelig3.png
        NO      maps/texture/zelig.png








EA      maps/texture/pharoah.png                



C     34,0,3        
 








SO      maps/texture/zelig4.png

 

1111
100111
1N1  11
111111

